5
4
5
0 3 1 2 9
7 3 4 9 9
1 7 5 5 3
2 3 4 2 5
1
6
0 1 2 3 4 5
8
17
1 4 2 3 2 2 1 6 8 5 7 6 1 8 9 2 7
9 5 4 3 1 2 3 3 4 1 1 3 8 7 4 2 7
7 9 3 1 9 8 6 5 0 2 8 6 0 2 4 8 6
5 0 9 0 0 6 1 3 8 9 3 4 4 6 0 6 6
1 8 4 9 6 3 7 8 8 2 9 1 3 5 9 8 4
0 7 6 3 6 1 5 4 2 0 9 7 3 7 2 6 0
1 6 5 7 5 4 1 2 0 0 1 4 6 0 7 1 7
7 7 7 3 3 5 9 9 8 1 8 2 6 6 0 3 8
12
17
4 0 6 1 8 9 8 4 1 4 3 9 8 8 0 8 7
7 8 3 8 3 7 1 0 7 3 4 9 6 5 1 0 9
9 6 8 3 4 8 4 9 9 2 5 5 3 3 3 7 4
3 8 0 8 8 0 6 8 1 9 8 9 7 2 2 8 2
8 9 0 7 8 1 5 8 6 1 2 4 2 5 8 6 2
6 5 3 9 2 4 6 1 8 2 1 1 9 7 6 2 9
5 2 0 0 3 9 1 8 1 9 5 3 2 5 2 5 8
6 7 7 2 2 9 4 1 9 6 9 8 2 5 5 4 9
1 2 5 0 8 3 9 3 9 6 7 9 9 7 6 9 3
5 7 6 6 5 8 2 5 4 4 1 6 1 6 3 3 5
5 3 2 8 2 5 3 6 1 8 6 2 1 4 6 2 9
1 5 0 3 6 4 9 2 9 3 4 4 0 5 9 6 3
14
16
2 8 0 7 2 2 5 9 1 0 8 5 0 7 9 0
5 3 4 1 0 4 8 5 9 2 5 4 1 3 9 5
8 2 7 9 6 1 7 7 1 9 0 3 4 1 7 5
3 3 2 4 1 2 9 0 8 7 4 5 6 8 0 7
7 4 3 1 3 6 3 0 1 9 0 4 2 9 3 1
4 8 2 0 5 5 9 3 2 8 7 4 8 1 4 3
5 5 2 6 8 9 2 9 5 9 4 5 0 5 8 8
0 1 3 2 2 2 7 0 3 1 3 3 7 0 9 5
5 8 3 7 8 3 7 9 3 9 1 8 2 8 0 1
8 4 8 6 0 9 3 0 0 8 7 6 3 5 6 5
8 3 9 4 8 3 9 7 6 4 5 8 6 1 5 5
1 9 6 4 5 4 2 5 3 2 6 8 2 6 6 3
9 4 5 6 2 5 3 5 6 6 1 4 4 6 2 6
8 2 5 5 1 0 1 5 1 7 6 0 0 2 4 3